NO ./textures/north.xpm
SO ./textures/south.xpm
WE ./textures/west.xpm
EA ./textures/east.xpm
F 80,100,80
C 225,30,80
                                          
  1111111111111111111111111       
  1000000000110000000000001       
  101100N001110000000000001       
  100100000000000000000000111111111       
  111111111011000001110000000000001       
  100000000011000001110111111111111       
  11110111111111011100000010001       
  11110111111111011101010010001       
  11000000110101011100000010001       
  10000000000000001100000010001       
  10000000000000001101010010001       
  1100000110010101111101111000111       
  11110111 1110101 101111010001       
  11111111 1111111 111111111111       
