11111111111111111111
1E000000C000000C0001
10000001111110000001
1000C000000000000P01
11111111111111111111
