11111111111111111111
10000100E00100000C01
100C0100000100000001
1000010000010C000001
10000000P00000000001
11111111111111111111
