11111111111111111111111111111111
10000000C000000000000000C0X00E01
10000011111111C00001111110000001
1X0000111111110000C1111110000C01
1C000011111111C00001111110000001
11110000000000000001111110000001
1P000000000C0000000000C000000001
11111111111111111111111111111111
