111111111111111111111111
1X00000000000000000E00X1
100000000000000000000001
100000000000000000000001
100000000000000000000001
1PC000000000000000000001
111111111111111111111111
