11111111111111111111
1E00000C000000C0001
10000001111110000001
10C00000000000P01
11111111111111111111
