NO ./textures/north.xpm
SO ./textures/south.xpm
WE ./textures/west.xpm
EA ./textures/east.xpm
F 2,15,150
C 225,30,200
11111111111
10001000001
1011N000011
10010000011
11111111111